11111111111111111111111111111111
10000000000000000000000000000001
10000000000000000000000000000001
10000000010000000000000000000001
10001000010000001111100000000001
10001000000000001000100000000001
100010000000000010N0100010000001
10000000000000001000100001000001
11111111111111111111111111111111