11111111111111
10000000000001
1000N000000001
10000000000001
10001000000001
10001000000001
11111111111111