NO wall_N.xpm
SO wall_E.xpm
WE wall_W.xpm
EA wall_S.xpm

C 3,0,105
F 186,170,91



111111111111111111111111111111111111
     1000001 10000000000000000000001
111111000001100000001001111111111D11
1111111110100000000000000000001
10001000010000001D1000000001001
1000100000000100000001000000001
1000100000000D0000S00D0010000001
10000000000001000000010000000001
100000000000000001D1000000000001
100000000000000001D1000000000001
10000000000000000000000000000001
10000000000000000000000000000001
10000000000000000000100000000001
10000000000000100001 10000000001
10000000000001 10000101000000001
11111111111111111111111111111111