NO wall_N.xpo
SO wall_E.xpm
WE wall_W.xpm
EA wall_S.xpm

F 186,170,91
C 3,0,105


11111111111111111111111111111111111111111111111111111111111
10000010000000001000000011111111111111111111111111111111111
10000010000000001000000011111111111111111111111111111111111
10000010000000001000000011111111111111111111111111111111111
1000001111D11111000000011111111111111111111111111111111111
10000000000W00000000000011111111111111111111111111111111111
10000000000000000000000011111111111111111111111111111111111
10000011111111111110000011111111111111111111111111111111111
10000010000000000010000011111111111111111111111111111111111
10000010000000000010000011111111111111111111111111111111111
10000010000000000010000011111111111111111111111111111111111
10000010000000000010000011111111111111111111111111111111111
100000111111D1111110000011111111111111111111111111111111111
10000000000000000000000011111111111111111111111111111111111
10000000000000000000000011111111111111111111111111111111111
10000000000000000000000011111111111111111111111111111111111
1000111111D111111000000011111111111111111111111111111111111
10001000000000001000000011111111111111111111111111111111111
10001000000000001000000011111111111111111111111111111111111
10001000000000001000000011111111111111111111111111111111111
10001000000000001000000011111111111111111111111111111111111
10001111111111111000000011111111111111111111111111111111111
10000000000000000000000011111111111111111111111111111111111
10000000000000000000000011111111111111111111111111111111111
11111111111111111111111111111111111111111111111111111111111