NO wall1.xpm
SO wall2.xpm
WE wall3.xpm
EA wall4.xpm

F 255,230,167
C 168,218,220



111111111111111111111111111111111111
     1000001 10000000000000000000001
11111100000110000000100111111111111
1111111110100000010000000000001
10001000010000001D1000000001001
1000100000000000010000000000001
100010000000000000N0010010000001
10000000000000000000000000000001
10000000000000000000000000000001
10000000000000000000000000000001
10000000000000000000000000000001
10000000000000000000000000000001
10000000000000000000100000000001
10000000000000100001 10000000001
10000000000001 10000101000000001
11111111111111111111111111111111