NO ./path_to_the_north_texture
SO ./path_to_the_south_texture
WE ./path_to_the_west_texture
EA ./path_to_the_east_texture

F 255,100,20
C 254,255,255




11111111111111111111111111111111
        10000000000000000000000000000001
        10000000000000000000010011111111
11111111101000000000000000000001
10001000010000000000010000000001
10001000000000000000000000000001
100010000000000000N0010010000001
10000000000000000000000000000001
10000000000000000000000000000001
10000000000000000000000000000001
10000000000000000000000000000001
10000000000000000000000000000001
10000000000000000000000000000001
10000000000000000001 10000000000001
10000000000000000000000000000001
11111111111111111111111111111111