NO wall_N.xpm
SO wall_S.xpm
WE wall_W.xpm
EA wall_E.xpm

F 12,125,12
C 6,62,150



111111111111111111111111111111111111
     1000001 10000000000000000000001
11111100000110000000100111111111111
11111111101000000000000000000001
10001000010000000000010000000001
10001000000000000000000000000001
100010000000000000N0010010000001
10000000000000000000000000000001
10000000000000000000000000000001
10000000000000000000000000000001
10000000000000000000000000000001
10000000000000000000000000000001
10000000000000000000100000000001
10000000000000100001 10000000001
10000000000001 10000101000000001
11111111111111111111111111111111