NO wall_N.xpm
SO wall_E.xpm
WE wall_W.xpm
EA wall_S.xpm

F 186,170,91
C 3,0,105


1111111111111111111111111
1S00001000000000100000001
1000001000000000100000001
1000001000000000100000001
1000001111D11111100000001
1000000000000000000000001
1000000000000000000000001
1000001111111111111000001
1000001000000000001000001
1000001000000000001000001
1000001000000000001000001
1000001000000000001000001
100000111111D111111000001
1000000000000000000000001
1000000000000000000000001
1000000000000000000000001
1000111111D11111100000001
1000100000000000100000001
1000100000000000100000001
1000100000000000100000001
1000100000000000100000001
1000111111111111100000001
1000000000000000000000001
1000000000000000000000001
1111111111111111111111111