NO wall_N.xpm
SO wall_E.xpm
WE wall_W.xpm
EA wall_S.xpm

F 186,170,91
C 3,0,105


111111111111111111111111111111111111
     1000001 10000000000000000000001
111111000001100000001001111111111011
111111111010000000000000000000111001
100010000100000000000000000100111011
100010000000010000000100000000111111
10001000000000000000000010000001
10000000000001000000010000000001
10000000001000000000000000000001
10000000000000010100000000000001
10000010001000000000000000000001
100000D00000000000001D1000000001
1000001S000000000000100000000001
10000000000000100001 10000000001
10000000000001 10000101000000001
11111111111111111111111111111111